Bridge Command Language file. To translate, please change the part after the 'equals' symbol
The characters \n will be replaced with a line break, so multiple lines of text are possible

This file must be saved with default (ANSI) encoding on Windows, and UTF-8 encoding on other platforms (Linux, OSX, ...)

ok="OK"
scnChoose="Veuillez choisir un sc�nario :"
secondary="Utiliser comme affichage secondaire"
secondaryWait="En attente de connexion. Le nom et le port de l'ordinateur sont :\n"
moveMessage="Veuillez d�placer cette fen�tre vers le moniteur o� Bridge Command doit �tre lanc� et cliquez sur OK."
multiplayer="Mode multijoueurs"
hostname="Optionnel: nom d'h�te pour contr�leur/moniteur secondaire.\nLaissez vide si inutile pour am�liorer la vitesse."
hostnameHelp="Noms d'h�te :\nD�marrez les moniteurs secondaires ou les sessions contr�leur d'abord.\nCeci permettra d'obtenir le nom d'h�te et le port.\nEntrez ces valeurs ici, comme nomhote:port\nUtilisez des virgules pour s�parer les noms d'h�tes."
udpListenPort="Port sur lequel recevoir les donn�es :"
udpListenPortHelp="En g�n�ral, laissez ce param�tre par d�faut. Il peut �tre modifi� si plus d'une instance du programme est lanc�e sur cet ordinateur."
loadingmsg="Chargement du sc�nario..."

pausedbutton="EN PAUSE: CLIQUEZ ICI POUR DEMARRER\n\nSouris :\nLe gouvernail, la machine et les contr�les sont cliquables.\nFaites un clic-droit sur les contr�les de la machine pour param�trer les deux moteurs en m�me temps.\nLa molette/le d�filement � deux doigts contr�le �galement le gouvernail.\n\nClavier :\nFl�ches : voir autour\n    Ctrl + Fl�ches : voir devant/b�bord/tribord/vers la poupe\n    Shift + Fl�che G/D : regarder autour par �tapes\nEspace : changer la vue\n   Shift + espace: Pour bloquer la vue en mode secondaire\n Ctrl + Shift + espace: Changer si la caméra se déplace avec le navire\n0-7 : compression temporelle\n'H' : sir�ne\n'M' : rel�cher un homme � la mer\nCtrl + 'M' : r�cup�rer un homme � la mer\n'A'/'Z' : contr�ler le moteur b�bord\n'S'/'X' : contr�ler le moteur tribord\n'D'/'C' : contr�ler les deux moteurs\n'V'/'B': contr�ler le gouvernail\nEsc : quitter\n\n Si les propulseurs d'�trave sont utilis�s alors \n 'D/A' Propulseur b�bord horaire / antihoraire \n 'L/D' Propulseur tribord horaire/antihoraire \n 'W/S' - Puissance b�bord augmenter / diminuer \n 'I/K' - Puissance tribord augmenter / diminuer\n"
startupHelpEngine="Cliquez ici pour contr�ler la machine\n\n Clic droit pour contr�ler les deux"
startupHelpRudder="Cliquez ici pour contr�ler le gouvernail"

pos = "Position : "
hdg="Cap : "
spd="Vitesse : "
kts="noeuds"
depth="Profondeur : "
zoom="Zoom"
range="Echelle : "
vrm="VRM : "
ebl="EBL : "
cursor="Curseur : "
minSymbol="'"
bearing="Rel�vement"
NFUPort="<"
NFUStbd=">"

portEngine="Mot.\nBbd"
stbdEngine="Mot.\nTbd"
engine="Machine"
bowThruster="Propulseur proue"
sternThruster="Propulseur poupe"

wheelText="Position barre & gouvernail"
rotText="Vitesse de rotation"
azimuthMaster="Param�trer ce contr�le comme ma�tre"

radarMainTab="Principal"
onoff="Marche/Arr�t"
radarEBLVRMTab="EBL\nVRM"
radarPITab="PI"
radarGuardZoneTab="Zone de\ngarde"
radarARPATab="ARPA"
radarTrackTab="Effacer\ntraces"
radarARPAVectorTab="Vecteur"
radarARPAAlarmTab="Alarme"
radarARPATrialTab="Essai"
parallelIndex="Index parall�le"
PIrange="Echelle NM"
PIbearing="Rel."
northUp="Nord"
courseUp="Route"
headUp="Cap"
increaserange="Echelle\n   +"
decreaserange="Echelle\n   -"
contact="Contact"
arpaContact="ARPA :"
marpaContact="MARPA :"
manualContact="Manuel :"
manualOrMarpa="Manuel/MARPA:"
manualLog="Analyse"
new="Nouvelle"
clear="Effacer"
past="Pass�"
gain="Gain"
rain="Pluie"
weather = "M�t�o"
visibility="Visibilit�"
clutter="Clutter"
eblLeft="EBL -"
eblRight="EBL +"
eblUp="VRM +"
eblDown="VRM -"
radarColour="Couleur"
arpa="ARPA"
cpa="CPA"
tcpa="TCPA"
arpaManual="Suivi Manuel"
MARPAon="MARPA activ�"
ARPAon="ARPA activ�"
marpaAcquire="MARPA"
untracked="Non suivi"
trueARPA="Vecteurs vrais"
relARPA="Vecteurs relatifs"
minsARPA="min."
bigRadar="^"
smallRadar="v"
fullScreenRadar="Radar plein �cran"
minimiseRadar="Petit radar"

nm=" NM"

paused="EN PAUSE"
collided="COLLISION !"
showinterface="Afficher"
hideinterface="Cacher"

exit="Quitter"

log="!"
extraControls="Contr�les suppl�mentaires"

lines="Amarres"

addLine="Ajouter ligne d'amarrage"
removeLine="Retirer l'amarre"
keepLineSlack="Gardez la ligne d’amarrage relâchée"
haulLineIn="Raidir la ligne d'amarrage"

pump1="Gouvernail pompe 1"
pump2="Gouvernail pompe 2"
pump1Working = "Gouvernail pompe 1 Marche"
pump1Failed = "Gouvernail pompe 1 Arr�t"
pump2Working = "Gouvernail pompe 2 Marche"
pump2Failed = "Gouvernail pompe 2 Arr�t"
followUpWorking = "Gouvernail : Follow up"
followUpFailed = "Gouvernail : Non follow up"
ackAlarms = "Acquitter"

hot = "Hauteur de marée: "

fps="FPS: "
