Bridge Command Language file. To translate, please change the part after the 'equals' symbol
The characters \n will be replaced with a line break, so multiple lines of text are possible

This file must be saved with default (ANSI) encoding on Windows, and UTF-8 encoding on other platforms (Linux, OSX, ...)

ok="OK"
scnChoose="Seleccione un escenario:"
secondary="Usar como pantalla secundaria"
secondaryWait="Esperando conexión. El nombre del equipo y el puerto son:\n"
moveMessage="Mueva esta ventana al monitor donde se iniciará Bridge Command y haga clic en OK."
multiplayer="Modo multijugador"
hostname="Opcional: nombre de host para controlador/pantalla secundaria.\nDéjelo en blanco si no es necesario para mejorar el rendimiento."
hostnameHelp="Nombres de host:\nInicie primero los monitores secundarios o las sesiones del controlador.\nEsto permitirá obtener el nombre de las máquinas y el puerto.\nIngrese estos valores aquí como nombre_maquina:puerto\nUse comas para separar las máquinas."
udpListenPort="Puerto para recibir datos:"
udpListenPortHelp="Generalmente, deje este valor por defecto. Puede modificarse si se ejecutan múltiples instancias del programa en este equipo."
loadingmsg="Cargando escenario..."

pausedbutton="PAUSADO: HAGA CLIC AQUÍ PARA COMENZAR\n\n"
normalpausedbutton="Ratón:\nEl timón, la máquina y los controles son interactivos.\nHaga clic derecho sobre los controles de la máquina para ajustar ambos motores a la vez.\nHacer "scroll" también controla el timón.\n\nTeclado:\nFlechas: mirar alrededor\nCtrl + Flechas: ver hacia proa/babor/estribor/popa\nMayús + Flechas izq/der: girar vista por etapas\nEspacio: cambiar vista\nMayús + espacio: bloquear vista en modo secundario\nCtrl + Mayús + espacio: alternar seguimiento de cámara con el buque\nF: mostrar/ocultar interfaz gráfica\n0-7: control de tiempo\n'H': sirena\n'M': lanzar hombre al agua\nCtrl + 'M': recuperar hombre al agua\n'A'/'Z': controlar motor de babor\n'S'/'X': controlar motor de estribor\n'D'/'C': controlar ambos motores\n'V'/'B': controlar timón\nEsc: salir\n\nSi se utilizan propulsores de proa:\n'D/A' Propulsor de babor horario/antihorario\n'L/J' Propulsor de estribor horario/antihorario\n'W/S': aumentar/disminuir potencia de babor\n'I/K': aumentar/disminuir potencia de estribor"
vrpausedbutton="Mostrar/ocultar esta vista VR 2D con el botón de menú del controlador VR.\n\nMientras se muestra la vista 2D VR, la interfaz se puede usar apuntando y seleccionando.\n\nCuando la vista 2D VR esté oculta:\n======================================\nControle los motores moviendo el controlador VR izquierdo con 'seleccionar' presionado.\nElija el motor a controlar inclinando el controlador izquierda/derecha, o manteniéndolo centrado para ambos.\n\nControle el timón moviendo el controlador VR derecho con 'seleccionar' presionado.\n\nSi se usan pods, contrólelos con los controles izquierdo y derecho presionando 'seleccionar'."
startupHelpEngine="Haga clic aquí para controlar la máquina\n\nClic derecho para controlar ambos motores"
startupHelpRudder="Haga clic aquí para controlar el timón"

pos ="Posición: "
hdg="Rumbo: "
spd="Velocidad: "
kts="nudos"
depth="Profundidad: "
zoom="Zoom"
magnification="Aumento"
view="Vista"
changeView="Vista"
range="Alcance: "
vrm="VRM: "
ebl="EBL: "
cursor="Cursor: "
minSymbol="'"
bearing="Demora"
NFUPort="<"
NFUStbd=">"

portEngine="Mot.\nBabor"
stbdEngine="Mot.\nEstribor"
engine="Máquina"
bowThruster="Propulsor de proa"
sternThruster="Propulsor de popa"

wheelText="Posición de la rueda y timón"
rotText="Velocidad de giro"
azimuthMaster="Establecer este control como maestro"

radarMainTab="Principal"
onoff="Encendido/Apagado"
radarEBLVRMTab="EBL\nVRM"
radarPITab="Índice paralelo"
radarGuardZoneTab="Zona de\nguardia"
radarARPATab="ARPA"
radarTrackTab="Borrar\ntrazas"
radarARPAVectorTab="Vector"
radarARPAAlarmTab="Alarma"
radarARPATrialTab="Prueba"
parallelIndex="Índice paralelo"
PIrange="Escala MN"
PIbearing="Demora"
northUp="Norte arriba"
courseUp="Rumbo arriba"
headUp="Proa arriba"
increaserange="Escala\n   +"
decreaserange="Escala\n   -"
contact="Contacto"
arpaContact="ARPA:"
marpaContact="MARPA:"
manualContact="Manual:"
manualOrMarpa="Manual/MARPA:"
manualLog="Registro"
new="Nuevo"
clear="Borrar"
past="Pasado"
gain="Ganancia"
rain="Lluvia"
weather ="Meteorología"
visibility="Visibilidad"
windDirection ="Dirección del viento"
windSpeed ="Velocidad del viento (kn)"
streamDirection ="Dirección de la corriente"
streamSpeed ="Velocidad de la corriente (kn)"
streamOverride ="Controlar corriente"
clutter="Ruido"
eblLeft="EBL -"
eblRight="EBL +"
eblUp="VRM +"
eblDown="VRM -"
radarColour="Color"
arpa="ARPA"
cpa="CPA"
tcpa="TCPA"
arpaManual="Seguimiento manual"
MARPAon="MARPA activado"
ARPAon="ARPA activado"
marpaAcquire="MARPA"
untracked="Sin seguimiento"
trueARPA="Vectores verdaderos"
relARPA="Vectores relativos"
minsARPA="min."
bigRadar="^"
smallRadar="v"
fullScreenRadar="Radar en pantalla completa"
minimiseRadar="Radar reducido"

nm=" MN"

paused="PAUSADO"
collided="¡COLISIÓN!"
showinterface="Mostrar"
hideinterface="Ocultar"

exit="Salir"

log="!"
extraControls="Controles adicionales"

lines="Amarras"

addLine="Agregar amarra"
removeLine="Quitar amarra"
keepLineSlack="Mantener amarra floja"
haulLineIn="Cobrar amarra"
anchorLine="Ancla"

rudderFailure="Fallo del timón"

pump1="Bomba timón 1"
pump2="Bomba timón 2"
pump1Working ="Bomba 1 activa"
pump1Failed ="Bomba 1 fallo"
pump2Working ="Bomba 2 activa"
pump2Failed ="Bomba 2 fallo"
followUpWorking ="Follow Up"
followUpFailed ="Sin Follow Up"
ackAlarms ="Acusar alarma"

hot ="Altura de marea: "

fps="FPS: "